RUS = "countries/Russia.txt"
DAN = "countries/Danzig.txt"
BRG = "countries/Burgundy.txt"
RKB = "countries/RK Belgium.txt"
RKH = "countries/RK Netherlands.txt"
RKF = "countries/RK France.txt"
RKN = "countries/RK Norway.txt"
RKD = "countries/RK Denmark.txt"
BOH = "countries/Bohmen Mahren.txt"
GGR = "countries/Generalgovernment.txt"
RKO = "countries/RK Ostland.txt"
RKU = "countries/RK Ukraine.txt"
RKM = "countries/RK Moscow.txt"
RKK = "countries/RK Caucasus.txt"
RKA = "countries/RK Wolga.txt"
LIV = "countries/Livonia.txt"
RKI = "countries/RK Italy.txt"
RKR = "countries/RK Nordbalkans.txt"
RKL = "countries/RK Southbalkans.txt"
RKG = "countries/RK Greece.txt"
GBR = "countries/Great Britain.txt"
RKP = "countries/RK Iberia.txt"
RKY = "countries/RK Turkey.txt"
RKX = "countries/RK Westsiberia.txt"
RKZ = "countries/RK Eastsiberia.txt"
RKV = "countries/RK Turkestan.txt"
ADR = "countries/Andorra.txt"
LIC = "countries/Liechtenstein.txt"
MCO = "countries/Monaco.txt"
SMR = "countries/San Marino.txt"
VAT = "countries/Vatican.txt"